20
********************
*G                 *
* * * **************
* * *  *           *
* **** * * * ** ****
*   *  * * ***     *
*** * ***   *  * * *
* * *** ****** *** *
* *              ***
* ************ * * *
* *          *** * *
* * ****** * *   * *
* * *    * * * * * *
* * **** ***   *** *
* *      * * ***   *
* ******** * * * ***
*          *       *
* **************** *
*                 C*
********************